요릭	판금 장화,신성한 파괴자,선체파괴자,스테락의 도전,삼위일체,도란의 방패,헤르메스의 발걸음,가시 갑옷,탐식의 망치,부패 물약
빅토르	마법사의 신발,부서진 여왕의 왕관,우주의 추진력,루덴의 폭풍,도란의 반지,리치베인,존야의 모래시계,그림자불꽃,쓸데없이 큰 지팡이,증폭의 고서
워윅	신성한 파괴자,판금 장화,거대한 히드라,티아맷,가시 갑옷,헤르메스의 발걸음,루비 수정,충전형 물약,덤불 조끼,제어 와드
베인	광전사의 군화,불멸의 철갑궁,구인수의 격노검,도란의 검,유령 무희,마법사의 최후,단검,몰락한 왕의 검,롱소드,충전형 물약
자이라	얼음 정수의 파편,마법사의 신발,리안드리의 고뇌,존야의 모래시계,제어 와드,모렐로노미콘,망각의 구,증폭의 고서,방출의 마법봉,충전형 물약
사이온	판금 장화,서리불꽃 건틀릿,가시 갑옷,부패 물약,헤르메스의 발걸음,란두인의 예언,덤불 조끼,종말의 겨울,태양불꽃 방패,루비 수정
클레드	판금 장화,거대한 히드라,태양불꽃 방패,스테락의 도전,도란의 검,선혈포식자,헤르메스의 발걸음,루비 수정,도란의 방패,탐식의 망치
오른	판금 장화,-,란두인의 예언,도란의 방패,가시 갑옷,헤르메스의 발걸음,덤불 조끼,종말의 겨울,천 갑옷,점화석
뽀삐	신성한 파괴자,판금 장화,망자의 갑옷,가시 갑옷,충전형 물약,헤르메스의 발걸음,덤불 조끼,제어 와드,루비 수정,부패 물약
세주아니	판금 장화,가시 갑옷,서리불꽃 건틀릿,태양불꽃 방패,헤르메스의 발걸음,충전형 물약,제어 와드,종말의 겨울,란두인의 예언,덤불 조끼
자크	서리불꽃 건틀릿,가시 갑옷,판금 장화,명석함의 아이오니아 장화,충전형 물약,태양불꽃 방패,정령의 형상,란두인의 예언,제어 와드,덤불 조끼
직스	마법사의 신발,리안드리의 고뇌,도란의 반지,모렐로노미콘,존야의 모래시계,대천사의 포옹,악마의 포옹,여신의 눈물,방출의 마법봉,증폭의 고서
쉔	판금 장화,서리불꽃 건틀릿,도란의 방패,가시 갑옷,헤르메스의 발걸음,태양불꽃 방패,덤불 조끼,란두인의 예언,거대한 히드라,제어 와드
말자하	리안드리의 고뇌,마법사의 신발,라일라이의 수정홀,존야의 모래시계,도란의 반지,모렐로노미콘,방출의 마법봉,악마의 포옹,명석함의 아이오니아 장화,증폭의 고서
블리츠크랭크	기동력의 장화,타곤 산의 방벽,강철의 솔라리 펜던트,제어 와드,지크의 융합,슈렐리아의 군가,점화석,타곤 산의 방패,천 갑옷,저녁갑주
코그모	광전사의 군화,불멸의 철갑궁,구인수의 격노검,마법사의 최후,루난의 허리케인,도란의 검,단검,란두인의 예언,크라켄 학살자,몰락한 왕의 검
마오카이	판금 장화,타곤 산의 방벽,제어 와드,망자의 갑옷,저녁갑주,덤불 조끼,신속의 장화,가시 갑옷,루비 수정,헤르메스의 발걸음
애니	마법사의 신발,루덴의 폭풍,존야의 모래시계,도란의 반지,모렐로노미콘,그림자불꽃,증폭의 고서,얼음 정수의 파편,쓸데없이 큰 지팡이,공허의 지팡이
쉬바나	마법사의 신발,밤의 수확자,내셔의 이빨,충전형 물약,몰락한 왕의 검,판금 장화,존야의 모래시계,제어 와드,증폭의 고서,모렐로노미콘
스웨인	존야의 모래시계,리안드리의 고뇌,마법사의 신발,얼음 정수의 파편,제어 와드,모렐로노미콘,증폭의 고서,망각의 구,악마의 포옹,방출의 마법봉
샤코	드락사르의 황혼검,광전사의 군화,징수의 총,명석함의 아이오니아 장화,충전형 물약,리안드리의 고뇌,얼음 정수의 파편,정수 약탈자,제어 와드,마법사의 신발
문도 박사	판금 장화,가시 갑옷,서리불꽃 건틀릿,정령의 형상,도란의 방패,태양불꽃 방패,란두인의 예언,헤르메스의 발걸음,덤불 조끼,워모그의 갑옷
렐	타곤 산의 방벽,판금 장화,저녁갑주,제어 와드,강철의 솔라리 펜던트,점화석,타곤 산의 방패,덤불 조끼,지크의 융합,가시 갑옷
제라스	마법사의 신발,루덴의 폭풍,얼음 정수의 파편,지평선의 초점,존야의 모래시계,제어 와드,마법공학 교류 발전기,증폭의 고서,모렐로노미콘,암흑의 인장
탐 켄치	서리불꽃 건틀릿,판금 장화,가시 갑옷,도란의 방패,헤르메스의 발걸음,덤불 조끼,정령의 형상,란두인의 예언,천 갑옷,루비 수정
나서스	신성한 파괴자,얼어붙은 심장,명석함의 아이오니아 장화,판금 장화,가시 갑옷,정령의 형상,도란의 방패,헤르메스의 발걸음,덤불 조끼,천 갑옷
그레이브즈	불멸의 철갑궁,요우무의 유령검,판금 장화,징수의 총,피바라기,충전형 물약,롱소드,헤르메스의 발걸음,민첩성의 망토,광전사의 군화
아무무	판금 장화,타곤 산의 방벽,강철의 솔라리 펜던트,가시 갑옷,제어 와드,태양불꽃 방패,덤불 조끼,헤르메스의 발걸음,저녁갑주,천 갑옷
엘리스	마법사의 신발,밤의 수확자,존야의 모래시계,충전형 물약,제어 와드,모렐로노미콘,증폭의 고서,그림자불꽃,마법공학 로켓 벨트,암흑의 인장
티모	내셔의 이빨,마법사의 신발,균열 생성기,도란의 반지,리안드리의 고뇌,모렐로노미콘,악마의 포옹,방출의 마법봉,증폭의 고서,광전사의 군화
질리언	명석함의 아이오니아 장화,얼음 정수의 파편,슈렐리아의 군가,제어 와드,화학공학 부패기,존야의 모래시계,만년서리,악마의 마법서,기동력의 장화,여신의 눈물
리산드라	마법사의 신발,존야의 모래시계,만년서리,도란의 반지,모렐로노미콘,루덴의 폭풍,부패 물약,증폭의 고서,망각의 구,제어 와드
소나	얼음 정수의 파편,명석함의 아이오니아 장화,월석 재생기,화학공학 부패기,여신의 눈물,슈렐리아의 군가,제어 와드,증폭의 고서,마법사의 신발,금지된 우상
레오나	타곤 산의 방벽,강철의 솔라리 펜던트,기동력의 장화,제어 와드,판금 장화,저녁갑주,점화석,지크의 융합,덤불 조끼,가시 갑옷
소라카	얼음 정수의 파편,월석 재생기,명석함의 아이오니아 장화,제어 와드,점화석,충전형 물약,구원,워모그의 갑옷,금지된 우상,슈렐리아의 군가
나미	얼음 정수의 파편,명석함의 아이오니아 장화,제국의 명령,화학공학 부패기,제어 와드,금지된 우상,증폭의 고서,불타는 향로,망각의 구,슈렐리아의 군가
신 짜오	판금 장화,선혈포식자,스테락의 도전,월식,충전형 물약,헤르메스의 발걸음,제어 와드,정수 약탈자,롱소드,죽음의 무도
퀸	광전사의 군화,불멸의 철갑궁,폭풍갈퀴,도란의 검,마법사의 최후,충전형 물약,징수의 총,무한의 대검,돌풍,민첩성의 망토
코르키	마법사의 신발,불멸의 철갑궁,무라마나,정수 약탈자,고속 연사포,무한의 대검,롱소드,여신의 눈물,콜필드의 전투 망치,수확의 낫
스카너	터보 화공 탱크,명석함의 아이오니아 장화,망자의 갑옷,충전형 물약,판금 장화,루비 수정,제어 와드,가시 갑옷,비상의 월갑,덤불 조끼
바이	신성한 파괴자,판금 장화,스테락의 도전,충전형 물약,칠흑의 양날 도끼,월식,헤르메스의 발걸음,롱소드,제어 와드,루비 수정
블라디미르	마법공학 로켓 벨트,우주의 추진력,마법사의 신발,존야의 모래시계,암흑의 인장,도란의 반지,명석함의 아이오니아 장화,증폭의 고서,쓸데없이 큰 지팡이,악마의 마법서
아우렐리온 솔	마법사의 신발,부패 물약,존야의 모래시계,만년서리,밤의 수확자,라일라이의 수정홀,모렐로노미콘,부서진 여왕의 왕관,증폭의 고서,그림자불꽃
브랜드	마법사의 신발,리안드리의 고뇌,얼음 정수의 파편,존야의 모래시계,모렐로노미콘,악마의 포옹,제어 와드,증폭의 고서,망각의 구,방출의 마법봉
애니비아	마법사의 신발,리안드리의 고뇌,존야의 모래시계,대천사의 포옹,여신의 눈물,도란의 반지,만년서리,얼음 정수의 파편,모렐로노미콘,제어 와드
카사딘	마법사의 신발,대천사의 포옹,존야의 모래시계,만년서리,부서진 여왕의 왕관,암흑의 인장,여신의 눈물,얼어붙은 심장,종말의 겨울,판금 장화
피들스틱	마법사의 신발,존야의 모래시계,리안드리의 고뇌,마법공학 로켓 벨트,제어 와드,모렐로노미콘,증폭의 고서,방출의 마법봉,망각의 구,공허의 지팡이
가렌	광전사의 군화,발걸음 분쇄기,망자의 갑옷,필멸자의 운명,도란의 방패,삼위일체,판금 장화,스테락의 도전,루비 수정,비상의 월갑
알리스타	타곤 산의 방벽,강철의 솔라리 펜던트,기동력의 장화,제어 와드,판금 장화,점화석,타곤 산의 방패,덤불 조끼,가시 갑옷,천 갑옷
럭스	마법사의 신발,루덴의 폭풍,얼음 정수의 파편,존야의 모래시계,지평선의 초점,제어 와드,증폭의 고서,모렐로노미콘,마법공학 교류 발전기,망각의 구
피즈	존야의 모래시계,루덴의 폭풍,마법사의 신발,부패 물약,리치베인,명석함의 아이오니아 장화,암흑의 인장,증폭의 고서,모렐로노미콘,방출의 마법봉
오공	신성한 파괴자,판금 장화,칠흑의 양날 도끼,스테락의 도전,헤르메스의 발걸음,도란의 방패,롱소드,콜필드의 전투 망치,충전형 물약,죽음의 무도
브라움	강철의 솔라리 펜던트,판금 장화,화이트록의 갑옷,제어 와드,타곤 산의 방벽,점화석,헤르메스의 발걸음,저녁갑주,기사의 맹세,덤불 조끼
카시오페아	대천사의 포옹,리안드리의 고뇌,존야의 모래시계,우주의 추진력,여신의 눈물,라일라이의 수정홀,증폭의 고서,만년서리,방출의 마법봉,모렐로노미콘
잭스	몰락한 왕의 검,신성한 파괴자,판금 장화,부패 물약,스테락의 도전,헤르메스의 발걸음,삼위일체,탐식의 망치,마법사의 최후,제어 와드
노틸러스	타곤 산의 방벽,강철의 솔라리 펜던트,제어 와드,판금 장화,기동력의 장화,저녁갑주,점화석,덤불 조끼,지크의 융합,가시 갑옷
초가스	판금 장화,서리불꽃 건틀릿,만년서리,가시 갑옷,헤르메스의 발걸음,종말의 겨울,마법사의 신발,도란의 반지,천 갑옷,덤불 조끼
트린다미어	광전사의 군화,돌풍,나보리 신속검,필멸자의 운명,무한의 대검,도란의 방패,민첩성의 망토,몰락한 왕의 검,크라켄 학살자,롱소드
케일	광전사의 군화,내셔의 이빨,균열 생성기,부패 물약,마법사의 최후,크라켄 학살자,존야의 모래시계,몰락한 왕의 검,방출의 마법봉,라바돈의 죽음모자
아크샨	광전사의 군화,불멸의 철갑궁,징수의 총,마법사의 최후,도란의 검,크라켄 학살자,판금 장화,롱소드,민첩성의 망토,무한의 대검
카밀	신성한 파괴자,판금 장화,굶주린 히드라,스테락의 도전,도란의 방패,헤르메스의 발걸음,도란의 검,롱소드,탐식의 망치,티아맷
신지드	라일라이의 수정홀,판금 장화,부패 물약,균열 생성기,헤르메스의 발걸음,악마의 포옹,신속의 장화,방출의 마법봉,암흑의 인장,거인의 허리띠
마스터 이	광전사의 군화,크라켄 학살자,구인수의 격노검,충전형 물약,몰락한 왕의 검,드락사르의 황혼검,징수의 총,마법사의 최후,판금 장화,롱소드
렉사이	자객의 발톱,판금 장화,밤의 끝자락,스테락의 도전,충전형 물약,헤르메스의 발걸음,롱소드,제어 와드,수호 천사,루비 수정
징크스	광전사의 군화,크라켄 학살자,고속 연사포,도란의 검,무한의 대검,돌풍,루난의 허리케인,민첩성의 망토,B.F. 대검,도미닉 경의 인사
진	돌풍,신속의 장화,징수의 총,고속 연사포,무한의 대검,민첩성의 망토,도란의 검,도미닉 경의 인사,충전형 물약,곡괭이
아리	마법사의 신발,루덴의 폭풍,존야의 모래시계,부패 물약,만년서리,지평선의 초점,도란의 반지,모렐로노미콘,그림자불꽃,증폭의 고서
비에고	불멸의 철갑궁,판금 장화,몰락한 왕의 검,충전형 물약,신성한 파괴자,정수 약탈자,헤르메스의 발걸음,마법사의 최후,제어 와드,롱소드
카직스	요우무의 유령검,드락사르의 황혼검,롱소드,톱날 단검,판금 장화,명석함의 아이오니아 장화,충전형 물약,밤의 끝자락,원칙의 원형낫,자객의 발톱
말파이트	판금 장화,서리불꽃 건틀릿,가시 갑옷,부패 물약,헤르메스의 발걸음,덤불 조끼,태양불꽃 방패,천 갑옷,마법사의 신발,란두인의 예언
라칸	타곤 산의 방벽,슈렐리아의 군가,제어 와드,명석함의 아이오니아 장화,화학공학 부패기,점화석,기동력의 장화,타곤 산의 방패,지크의 융합,망각의 구
벨코즈	마법사의 신발,얼음 정수의 파편,루덴의 폭풍,존야의 모래시계,리안드리의 고뇌,모렐로노미콘,제어 와드,지평선의 초점,망각의 구,증폭의 고서
애쉬	광전사의 군화,불멸의 철갑궁,도란의 검,마법사의 최후,구인수의 격노검,루난의 허리케인,단검,롱소드,유령 무희,몰락한 왕의 검
자야	월식,명석함의 아이오니아 장화,무라마나,롱소드,세릴다의 원한,광전사의 군화,콜필드의 전투 망치,톱날 단검,충전형 물약,돌풍
트런들	판금 장화,신성한 파괴자,헤르메스의 발걸음,거대한 히드라,충전형 물약,정수 약탈자,가시 갑옷,제어 와드,루비 수정,스테락의 도전
람머스	터보 화공 탱크,가시 갑옷,판금 장화,충전형 물약,망자의 갑옷,천 갑옷,덤불 조끼,헤르메스의 발걸음,루비 수정,제어 와드
시비르	드락사르의 황혼검,명석함의 아이오니아 장화,무라마나,롱소드,세릴다의 원한,광전사의 군화,징수의 총,톱날 단검,콜필드의 전투 망치,여신의 눈물
룰루	명석함의 아이오니아 장화,슈렐리아의 군가,얼음 정수의 파편,제어 와드,화학공학 부패기,금지된 우상,증폭의 고서,불타는 향로,망각의 구,밴들유리 거울
릴리아	리안드리의 고뇌,존야의 모래시계,명석함의 아이오니아 장화,악마의 포옹,마법사의 신발,충전형 물약,우주의 추진력,얼어붙은 심장,증폭의 고서,모렐로노미콘
헤카림	신성한 파괴자,명석함의 아이오니아 장화,스테락의 도전,충전형 물약,판금 장화,망자의 갑옷,죽음의 무도,제어 와드,루비 수정,요우무의 유령검
베이가	마법사의 신발,존야의 모래시계,만년서리,루덴의 폭풍,얼음 정수의 파편,라바돈의 죽음모자,도란의 반지,쓸데없이 큰 지팡이,명석함의 아이오니아 장화,부서진 여왕의 왕관
피오라	판금 장화,굶주린 히드라,선혈포식자,도란의 검,신성한 파괴자,스테락의 도전,헤르메스의 발걸음,롱소드,탐식의 망치,죽음의 무도
하이머딩거	마법사의 신발,존야의 모래시계,리안드리의 고뇌,도란의 반지,모렐로노미콘,루덴의 폭풍,증폭의 고서,망각의 구,방출의 마법봉,라바돈의 죽음모자
벡스	마법사의 신발,루덴의 폭풍,존야의 모래시계,지평선의 초점,부패 물약,증폭의 고서,마법공학 교류 발전기,얼음 정수의 파편,악마의 마법서,제어 와드
모르가나	얼음 정수의 파편,존야의 모래시계,리안드리의 고뇌,마법사의 신발,명석함의 아이오니아 장화,제어 와드,망각의 구,증폭의 고서,모렐로노미콘,기동력의 장화
에코	마법공학 로켓 벨트,마법사의 신발,리치베인,존야의 모래시계,충전형 물약,암흑의 인장,제어 와드,증폭의 고서,쓸데없이 큰 지팡이,그림자불꽃
카서스	리안드리의 고뇌,마법사의 신발,존야의 모래시계,모렐로노미콘,악마의 포옹,공허의 지팡이,라바돈의 죽음모자,충전형 물약,쓸데없이 큰 지팡이,증폭의 고서
야스오	광전사의 군화,불멸의 철갑궁,필멸자의 운명,무한의 대검,도란의 검,B.F. 대검,민첩성의 망토,죽음의 무도,피바라기,곡괭이
트위치	광전사의 군화,크라켄 학살자,루난의 허리케인,몰락한 왕의 검,도란의 검,무한의 대검,단검,내셔의 이빨,충전형 물약,민첩성의 망토
이렐리아	몰락한 왕의 검,판금 장화,불멸의 철갑궁,도란의 검,헤르메스의 발걸음,죽음의 무도,마법사의 최후,선혈포식자,롱소드,수호 천사
킨드레드	광전사의 군화,크라켄 학살자,징수의 총,고속 연사포,충전형 물약,무한의 대검,돌풍,판금 장화,제어 와드,민첩성의 망토
탈리야	마법사의 신발,존야의 모래시계,루덴의 폭풍,만년서리,모렐로노미콘,공허의 지팡이,충전형 물약,제어 와드,암흑의 인장,증폭의 고서
요네	광전사의 군화,불멸의 철갑궁,필멸자의 운명,무한의 대검,도란의 검,B.F. 대검,도란의 방패,민첩성의 망토,피바라기,죽음의 무도
우디르	판금 장화,망자의 갑옷,터보 화공 탱크,충전형 물약,헤르메스의 발걸음,가시 갑옷,루비 수정,비상의 월갑,제어 와드,대자연의 힘
일라오이	스테락의 도전,판금 장화,부패 물약,신성한 파괴자,선혈포식자,헤르메스의 발걸음,죽음의 무도,가시 갑옷,서리불꽃 건틀릿,정령의 형상
우르곳	판금 장화,거대한 히드라,선체파괴자,칠흑의 양날 도끼,서리불꽃 건틀릿,헤르메스의 발걸음,도란의 검,선혈포식자,루비 수정,가시 갑옷
사미라	불멸의 철갑궁,징수의 총,판금 장화,도란의 검,무한의 대검,민첩성의 망토,도미닉 경의 인사,피바라기,B.F. 대검,광전사의 군화
자르반 4세	선혈포식자,판금 장화,스테락의 도전,충전형 물약,헤르메스의 발걸음,제어 와드,루비 수정,수호 천사,가시 갑옷,탐식의 망치
나르	판금 장화,신성한 파괴자,스테락의 도전,도란의 검,헤르메스의 발걸음,도란의 방패,가시 갑옷,루비 수정,덤불 조끼,탐식의 망치
미스 포츈	광전사의 군화,월식,징수의 총,요우무의 유령검,도란의 검,롱소드,크라켄 학살자,세릴다의 원한,톱날 단검,얼음 정수의 파편
케이틀린	광전사의 군화,돌풍,고속 연사포,폭풍갈퀴,도란의 검,징수의 총,무한의 대검,민첩성의 망토,B.F. 대검,충전형 물약
르블랑	루덴의 폭풍,마법사의 신발,부패 물약,우주의 추진력,존야의 모래시계,암흑의 인장,악마의 마법서,증폭의 고서,공허의 지팡이,모렐로노미콘
아칼리	마법사의 신발,존야의 모래시계,마법공학 로켓 벨트,균열 생성기,도란의 방패,그림자불꽃,모렐로노미콘,증폭의 고서,악마의 포옹,방출의 마법봉
잔나	얼음 정수의 파편,슈렐리아의 군가,제어 와드,화학공학 부패기,명석함의 아이오니아 장화,기동력의 장화,신속의 장화,증폭의 고서,금지된 우상,망각의 구
그라가스	마법사의 신발,존야의 모래시계,밤의 수확자,명석함의 아이오니아 장화,제어 와드,충전형 물약,만년서리,모렐로노미콘,증폭의 고서,망각의 구
트리스타나	광전사의 군화,크라켄 학살자,도란의 검,유령 무희,무한의 대검,폭풍갈퀴,고속 연사포,민첩성의 망토,돌풍,B.F. 대검
타릭	타곤 산의 방벽,강철의 솔라리 펜던트,판금 장화,제어 와드,점화석,여신의 눈물,종말의 겨울,명석함의 아이오니아 장화,저녁갑주,헤르메스의 발걸음
트위스티드 페이트	만년서리,고속 연사포,명석함의 아이오니아 장화,부패 물약,존야의 모래시계,리치베인,마법사의 신발,제어 와드,헤르메스의 발걸음,암흑의 인장
케인	명석함의 아이오니아 장화,선혈포식자,요우무의 유령검,롱소드,충전형 물약,무라마나,판금 장화,드락사르의 황혼검,칠흑의 양날 도끼,콜필드의 전투 망치
다이애나	마법사의 신발,마법공학 로켓 벨트,존야의 모래시계,모렐로노미콘,내셔의 이빨,충전형 물약,증폭의 고서,제어 와드,방출의 마법봉,망각의 구
드레이븐	불멸의 철갑궁,징수의 총,광전사의 군화,도란의 검,무한의 대검,도미닉 경의 인사,판금 장화,민첩성의 망토,롱소드,B.F. 대검
카르마	얼음 정수의 파편,명석함의 아이오니아 장화,슈렐리아의 군가,화학공학 부패기,제어 와드,증폭의 고서,망각의 구,금지된 우상,불타는 향로,흐르는 물의 지팡이
이즈리얼	명석함의 아이오니아 장화,무라마나,신성한 파괴자,도란의 검,세릴다의 원한,롱소드,얼어붙은 심장,삼위일체,콜필드의 전투 망치,여신의 눈물
카타리나	마법사의 신발,내셔의 이빨,마법공학 로켓 벨트,존야의 모래시계,암흑의 인장,증폭의 고서,충전형 물약,공허의 지팡이,방출의 마법봉,라바돈의 죽음모자
볼리베어	신성한 파괴자,판금 장화,명석함의 아이오니아 장화,스테락의 도전,가시 갑옷,충전형 물약,루비 수정,도란의 방패,덤불 조끼,망자의 갑옷
세트	판금 장화,선혈포식자,스테락의 도전,도란의 방패,발걸음 분쇄기,루비 수정,헤르메스의 발걸음,몰락한 왕의 검,탐식의 망치,거대한 히드라
사일러스	만년서리,존야의 모래시계,명석함의 아이오니아 장화,우주의 추진력,도란의 반지,마법사의 신발,모렐로노미콘,악마의 마법서,증폭의 고서,암흑의 인장
갈리오	존야의 모래시계,판금 장화,마법공학 로켓 벨트,타곤 산의 방벽,도란의 반지,헤르메스의 발걸음,제어 와드,만년서리,마법사의 신발,슈렐리아의 군가
케넨	마법공학 로켓 벨트,마법사의 신발,존야의 모래시계,도란의 검,모렐로노미콘,공허의 지팡이,증폭의 고서,망각의 구,제어 와드,방출의 마법봉
누누와 윌럼프	마법사의 신발,태양불꽃 방패,판금 장화,충전형 물약,존야의 모래시계,망자의 갑옷,마법공학 로켓 벨트,공허의 지팡이,제어 와드,만년서리
오리아나	마법사의 신발,루덴의 폭풍,부패 물약,존야의 모래시계,모렐로노미콘,그림자불꽃,도란의 반지,대천사의 포옹,쓸데없이 큰 지팡이,증폭의 고서
다리우스	판금 장화,스테락의 도전,발걸음 분쇄기,삼위일체,망자의 갑옷,헤르메스의 발걸음,도란의 방패,루비 수정,도란의 검,비상의 월갑
녹턴	원칙의 원형낫,드락사르의 황혼검,판금 장화,롱소드,충전형 물약,톱날 단검,헤르메스의 발걸음,명석함의 아이오니아 장화,제어 와드,요우무의 유령검
신드라	마법사의 신발,루덴의 폭풍,존야의 모래시계,부패 물약,그림자불꽃,공허의 지팡이,도란의 반지,모렐로노미콘,쓸데없이 큰 지팡이,증폭의 고서
모데카이저	균열 생성기,판금 장화,내셔의 이빨,도란의 방패,악마의 포옹,존야의 모래시계,헤르메스의 발걸음,방출의 마법봉,증폭의 고서,거인의 허리띠
탈론	요우무의 유령검,명석함의 아이오니아 장화,월식,롱소드,톱날 단검,충전형 물약,밤의 끝자락,자객의 발톱,원칙의 원형낫,독사의 송곳니
쓰레쉬	기동력의 장화,강철의 솔라리 펜던트,화이트록의 갑옷,제어 와드,점화석,타곤 산의 방벽,지크의 융합,기사의 맹세,저녁갑주,덤불 조끼
니코	마법사의 신발,존야의 모래시계,마법공학 로켓 벨트,얼음 정수의 파편,모렐로노미콘,도란의 반지,제어 와드,만년서리,루덴의 폭풍,증폭의 고서
제드	드락사르의 황혼검,요우무의 유령검,명석함의 아이오니아 장화,롱소드,원칙의 원형낫,톱날 단검,충전형 물약,밤의 끝자락,헤르메스의 발걸음,콜필드의 전투 망치
레넥톤	선혈포식자,판금 장화,스테락의 도전,헤르메스의 발걸음,도란의 검,도란의 방패,칠흑의 양날 도끼,몰락한 왕의 검,탐식의 망치,수호 천사
럼블	마법사의 신발,밤의 수확자,존야의 모래시계,모렐로노미콘,마법공학 로켓 벨트,증폭의 고서,도란의 방패,망각의 구,충전형 물약,도란의 반지
리븐	선혈포식자,칠흑의 양날 도끼,명석함의 아이오니아 장화,판금 장화,도란의 검,죽음의 무도,롱소드,콜필드의 전투 망치,도란의 방패,스테락의 도전
판테온	월식,판금 장화,롱소드,화이트록의 갑옷,톱날 단검,헤르메스의 발걸음,요우무의 유령검,제어 와드,부패 물약,칠흑의 양날 도끼
루시안	돌풍,정수 약탈자,광전사의 군화,도란의 검,무한의 대검,판금 장화,징수의 총,롱소드,세릴다의 원한,민첩성의 망토
세나	검은 안개 낫,신속의 장화,크라켄 학살자,고속 연사포,신성한 파괴자,구인수의 격노검,제어 와드,광전사의 군화,롱소드,단검
이블린	마법사의 신발,마법공학 로켓 벨트,리치베인,밤의 수확자,충전형 물약,암흑의 인장,그림자불꽃,공허의 지팡이,메자이의 영혼약탈자,존야의 모래시계
파이크	기동력의 장화,화이트록의 갑옷,드락사르의 황혼검,그림자 검,톱날 단검,롱소드,요우무의 유령검,원칙의 원형낫,자객의 발톱,룬 강철 어깨 갑옷
제이스	월식,무라마나,명석함의 아이오니아 장화,요우무의 유령검,롱소드,세릴다의 원한,도란의 검,판금 장화,톱날 단검,콜필드의 전투 망치
카이사	광전사의 군화,징수의 총,돌풍,크라켄 학살자,도란의 검,유령 무희,무한의 대검,롱소드,톱날 단검,고속 연사포
바드	얼음 정수의 파편,기동력의 장화,제어 와드,슈렐리아의 군가,타곤 산의 방벽,강철의 솔라리 펜던트,신속의 장화,망자의 갑옷,점화석,명석함의 아이오니아 장화
리 신	선혈포식자,제어 와드,판금 장화,스테락의 도전,칠흑의 양날 도끼,충전형 물약,헤르메스의 발걸음,명석함의 아이오니아 장화,콜필드의 전투 망치,롱소드
아트록스	선혈포식자,판금 장화,스테락의 도전,도란의 방패,헤르메스의 발걸음,죽음의 무도,칠흑의 양날 도끼,콜필드의 전투 망치,탐식의 망치,루비 수정
칼리스타	광전사의 군화,불멸의 철갑궁,루난의 허리케인,구인수의 격노검,도란의 검,단검,마법사의 최후,피바라기,흡혈의 낫,민첩성의 망토
니달리	마법사의 신발,존야의 모래시계,마법공학 로켓 벨트,밤의 수확자,충전형 물약,지평선의 초점,공허의 지팡이,암흑의 인장,제어 와드,증폭의 고서
세라핀	얼음 정수의 파편,명석함의 아이오니아 장화,월석 재생기,화학공학 부패기,제어 와드,증폭의 고서,마법사의 신발,슈렐리아의 군가,망각의 구,라일라이의 수정홀
갱플랭크	삼위일체,부패 물약,명석함의 아이오니아 장화,징수의 총,필멸자의 운명,판금 장화,정수 약탈자,무한의 대검,불멸의 철갑궁,스테락의 도전
유미	얼음 정수의 파편,월석 재생기,제어 와드,화학공학 부패기,증폭의 고서,루덴의 폭풍,금지된 우상,망각의 구,요정의 부적,흐르는 물의 지팡이
조이	루덴의 폭풍,마법사의 신발,부패 물약,지평선의 초점,존야의 모래시계,증폭의 고서,암흑의 인장,마법공학 교류 발전기,제어 와드,악마의 마법서
아지르	마법사의 신발,루덴의 폭풍,존야의 모래시계,도란의 반지,내셔의 이빨,리안드리의 고뇌,모렐로노미콘,증폭의 고서,부서진 여왕의 왕관,공허의 지팡이
바루스	불멸의 철갑궁,광전사의 군화,도란의 검,구인수의 격노검,드락사르의 황혼검,롱소드,마법사의 최후,무라마나,명석함의 아이오니아 장화,판금 장화
렝가	판금 장화,월식,드락사르의 황혼검,요우무의 유령검,롱소드,도란의 검,원칙의 원형낫,톱날 단검,명석함의 아이오니아 장화,충전형 물약
그웬	균열 생성기,내셔의 이빨,판금 장화,존야의 모래시계,우주의 추진력,도란의 검,헤르메스의 발걸음,증폭의 고서,충전형 물약,악마의 마법서
아펠리오스	광전사의 군화,불멸의 철갑궁,징수의 총,무한의 대검,돌풍,도란의 검,민첩성의 망토,도미닉 경의 인사,곡괭이,루난의 허리케인
라이즈	부서진 여왕의 왕관,대천사의 포옹,마법사의 신발,만년서리,우주의 추진력,종말의 겨울,여신의 눈물,명석함의 아이오니아 장화,존야의 모래시계,헤르메스의 발걸음
올라프	선혈포식자,판금 장화,스테락의 도전,충전형 물약,죽음의 무도,루비 수정,헤르메스의 발걸음,제어 와드,칠흑의 양날 도끼,가시 갑옷
아이번	명석함의 아이오니아 장화,월석 재생기,화학공학 부패기,충전형 물약,기동력의 장화,제어 와드,증폭의 고서,존야의 모래시계,슈렐리아의 군가,망가진 초시계
키아나	요우무의 유령검,명석함의 아이오니아 장화,롱소드,자객의 발톱,톱날 단검,원칙의 원형낫,충전형 물약,월식,드락사르의 황혼검,세릴다의 원한
